b6b6b6b6b6b6g0g0g0b6b6b6b6b6b6b6b6b6b6b6b6b6b6b6b6b6b6b6b6b6b6b6b6b6b6b6b6b6b6b6
g0g0g0g0g0g0g0g0g0g0g0g0g0g0g0b6g0g0g0g0g0g0g0g0g0g0g0g0g0g0g0g0g0g0g0g0g0g0g0g0
g0g0g0g0g0g0g0g0g0g0g0g0g0g0g0b6g0g0g0g0g0g0g0g0g0g0g0g0g0g0g0g0g0g0g0g0g0g0g0g0
g0g0g0g0g0g0g0g0g0g0g0g0g0g0g0b6g0g0g0g0g0g0g0g0g0g0g0g0g0g0g0g0g0g0g0g0g0g0g0g0
b6b6b6b6b6b6g0g0g0g0g0g0g0g0g0b6g0g0g0g0g0g0g0g0g0g0g0g0g0g0g0g0g0g0g0b6b6b6b6b6
g0g0g0g0g0g0g0g0g0g0g0g0g0g0g0b6g0g0g0g0g0g0g0g0g0g0g0g0g0g0g0g0g0g0g0b6g0g0g0g0
g0g0g0g0g0g0g0g0g0g0g0g0g0g0g0b6g0g0g0g0g0g0g0g0g0g0g0g0g0g0g0g0g0g0g0b6g0g0g0g0
g0g0g0g0g0g0g0g0g0g0g0g0g0g0g0b6g0g0g0g0g0g0g0g0g0g0g0g0g0g0g0g0g0g0g0b6g0g0g0g0
g0g0g0g0g0g0g0g0g0g0g0g0g0g0g0g0g0g0g0g0g0g0g0g0g0g0g0g0g0g0g0g0g0g0g0g0g0g0g0g0
g0g0g0g0g0g0g0g0g0g0g0g0g0g0g0g0g0g0g0g0g0g0g0g0g0g0g0g0g0g0g0g0g0g0g0g0g0g0g0g0
g0g0g0g0g0g0g0g0g0g0g0g0g0g0g0g0g0g0g0g0g0g0g0g0g0g0g0g0g0g0g0g0g0g0g0g0g0g0g0g0
g0g0g0g0g0g0g0g0g0g0g0g0g0g0g0g0g0g0g0g0g0g0g0g0g0g0g0g0g0g0g0g0g0g0g0g0g0g0g0g0
g0g0g0g0g0g0g0g0g0g0g0g0g0g0g0g0g0g0g0g0g0g0g0g0g0g0g0g0g0g0g0g0g0g0g0g0g0g0g0g0
g0g0g0g0g0g0g0g0g0g0g0g0g0g0g0g0g0g0g0g0g0g0g0g0g0g0g0g0g0g0g0g0g0g0g0g0g0g0g0g0
g0g0g0g0g0g0g0g0g0g0g0g0g0g0g0g0g0g0g0g0g0g0g0g0g0g0g0g0g0g0g0g0g0g0g0g0g0g0g0g0
g0g0g0g0g0g0g0g0g0g0g0g0g0g0g0g0g0g0g0g0g0g0g0g0g0g0g0g0g0g0g0g0g0g0g0g0g0g0g0g0
g0g0g0g0g0g0g0g0g0g0g0g0g0g0g0g0g0g0g0g0g0g0g0g0g0g0g0g0g0g0g0g0g0g0g0g0g0g0g0g0
b6g0g0g0g0g0g0g0g0g0g0g0g0g0g0g0g0g0g0g0g0g0g0g0g0g0g0g0g0g0g0g0g0g0g0g0g0g0g0g0
b6g0g0g0g0g0g0g0g0g0g0g0g0g0g0g0g0g0g0g0g0g0g0g0g0w5w5w5w5w5w5w5w5w5w5w5w5w5w5w5
b6g0g0g0g0g0g0g0g0g0g0g0g0g0g0g0g0g0g0g0g0g0g0w5w5w5w5w5w5w5w5w5w5w5w5w5w5w5w5w5
b6g0g0g0g0g0g0g0g0g0g0g0g0g0g0g0g0g0g0g0g0w5w5w5w5w5w5w5w5w5w5w5w5w5w5w5w5w5w5w5
b6g0g0g0g0g0g0g0g0g0g0g0g0g0g0g0g0g0g0g0w5w5w5w5w5w5w5w5w5w5w5w5w5w5w5w5w5w5w5w5
b6g0g0g0g0g0g0g0g0g0g0g0g0g0g0g0g0g0g0w5w5w5w5w5w5w5w5w5w5w5w5w5w5w5w5w5w5w5w5w5
b6g0g0g0g0g0g0g0g0g0g0g0g0g0g0g0g0g0w5w5w5w5w5w5w5w5w5w5w5w5w5w5w5w5w5w5w5w5w5w5
b6g0g0g0g0g0g0g0g0g0g0g0g0g0g0g0g0w5w5w5w5w5w5w5w5w5w5w5w5w5w5w5w5w5w5w5w5w5w5w5
b6g0g0g0g0g0g0g0g0g0g0g0g0g0g0g0g0w5w5w5w5w5w5w5w5w5w5w5w5w5w5w5w5w5w5w5w5w5w5w5
b6g0g0g0g0g0g0g0g0g0g0g0g0g0g0g0w5w5w5w5w5w5w5w5w5w5w5w5w5w5w5w5w5w5w5w5w5w5w5w5
b6g0g0g0g0g0g0g0g0g0g0g0g0g0g0g0w5w5w5w5w5w5w5w5w5w5w5w5w5w5w5w5w5w5w5w5w5w5w5w5
b6g0g0g0g0g0g0g0g0g0g0g0g0g0g0w5w5w5w5w5w5w5w5w5w5w5w5w5w5w5w5w5w5w5w5w5w5w5w5w5
b6b6b6b6b6b6g0g0g0b6b6b6b6b6b6w5w5w5w5w5w5w5w5w5w5w5w5w5w5w5w5w5w5w5w5w5w5w5w5w5